"|==================|",
"|.......  .F.......|",
"|.===.5=.=====.===.|",
"|.....F............|",
"|.===.=====.==.===.|",
"|..................|",
"|.....===...==.....|",
"|............F.....|",
"|==================|"